1111111111111111111111111111111111
100000000000000C00000E0000000P0001
1111111111111111111111111111111111
